<map>
0000000000000000000000000000010100000000000000000000000000040404040000000000000000000000000000000404040000000000000000000000000000000404010104040400000000000000000000000000000000000000000000000000000000000000000000000000000000000000000400000000000000000000000000000000000000000000000000000000000000000000000000000000000000000000000000000000000000000000000000000000000000000000000000000000000000000000000000000101010101010101010101010101010101010101010101010101010101010101
0000000000000000000000000000010100000000000000000000000004010101010404000000000000000000000000040101010000000000000000000000000000000606010101010104000000000000040400000000000000000000000000000000000000000000000000000000000000000000000100000000000000000000000000000000000000000000000000000000000000000000000000000000000000000000000000000000000000000000000000000000000000000000000000000000000000000000000000000101010101010101010101010101010101010101010101010101010101010101
0000000000000000000000000000010100000000000000000000000001010101010101040000000000000000000004010101060000000000000000000000000000000000060601010101040404040404010600000000000000000000000000000000060000000000000000000000000000000000000100000000000000000000000000000000000000000000000000000000000000000000000000000000000000000000000000000000000000000000000000000000000000000000000000000000000000000000000000000101010101010101010101010101010101010101010101010101010101010101
0000000000000000000000000000121300000000000000000000000006060101010101010404040404040400000401010106000000000000000000000000000000000000000006060101010101010101010000000000000000000000000000000000000000000000000000000000000000000000000100000000000000000000000000000000000000000000000000000000000000000000000000000000000000000000000000000000000000000000000000000000000000000000000000000000000000000000000000000101010101010101010101010101010101010101010101010101010101010101
0000000000000000000000000000000000000000000000000000000000000601010101010101010101010104040101010600000000000000000000000000000000000000000000000606010101010106060000000000000000000000000000000000000000000000000000000000000000000000000100000000000000000006000000000000000000000000000000000000000000000000000000000000000000000000000000000000000000000000000000000000000000000000000000000000000000000000000000000101010101010101010101010101010101010101010101010101010101010101
0101010101010101010101010101101001010101010101010000000000000006060101010101010106060606060601010000000000000000000000000000040404000000000000000000060101010100000000000000000000000000000600000000000000000000000000000000000000000000000600000000000000000000000000000000000000000000000000000000000000000000000000000000000000000000000000000000000000000000000000000000000000000000000000000000000000000000000000001213141512131415121314151213141512131415111111111111010101010101
0101010101010101010101010101010101010101010101010000000000000000000601010101060600000000000006060000000000000000000000000404010101040400000000000000000601010100000000000000000000000000000000000000000000000000000000000000000000000000000000000000000000000000000000000000000000000000000000000000000000000000000000000000000000000000000000000000000000000000000000000000000000000000000000000000000000000000000000000000000000000000000000000000000000000000000000000011010101010101
0601010101010101010101010101010101010101010101010000000000000000000006010106000000000000000000000000000000000000000004040101010601010104000000000000000001010100000000000000000000000000000000000000000000000000000000000000000000000600000000000000060000000000000000000000000000000000000006000000000006000000000006000000000006000000000006000000000006000000000006000000000006000000000006000000000006000000000001011010101010101010101010101010101010101010111111111111010101010101
0006010101010101010101010101010101010101010106060000000000000000000000010600000000000000000000000000000000000000040401010101060006060101040000000000000001010100000000000000000006000000000000000000000000000000000000000000000000000000000000000000000000000000000000000000000000000000000000000000000000000000000000000000000000000000000000000000000000000000000000000000000000000000000000000000000000000000000000010101010101010101010101010101010101010101010101010101010101010101
0000010101010101010101010101010101010101010600000000000000000000000000060000000000000404000000000000000000000000010101010106000000000101010400000000000001140100000000000000000000000000000000000000000000000000000000000000000000000000000000000000000000000000000000000000000000000000000000000000000000000000000000000000000000000000000000000000000000000000000000000000000000000000000000000000000000000000000000000101010101010101010101010101010101010101010101010101010101010101
0000060601010101010101010101010101010101060000000000000000000000000000000000000004040101040000000000000000000404010101010600000000000606060104000000000000000000000000000000000000000000000000000000000000000000000000000006000000000000000600000000000000000000000000000000000000060000000000000000000000000000000000000000000000000000000000000000000000000000000000000000000000000000000000000000000000000000000000000101010101010101010101010101010101010101010101010101010101010101
0000000006010101010106060101010101010106000000000000000000000000000000000000000401010606010404000000101000000101010606060000000000000000000601010101010101100101010101010000000000000000000000000000000000000000000000000000000000000000000000000000000000000000000000000000000000000000000000000000000000000000000000000000000000000000000000000000000000000000000000000000000000000000000000000000000000000000000000000101010101010101010101010101010101010101010101010101010101010101
0000000000060601010600000601010101010600000000000000000000000000000001010101010106060000060606040404010104040106060000000000000000000000000006060601010101010101010101060000000000000000000000000000000000000000000000000000000000000000000000000000000000000000000000000000000000000000000000000000000000000000000000000000000000000000000000000000000000000000000000000000000000000000000000000000000000000000000000000101010101010101010101010101010101010101010101010101010101010101
0000000000000006060000000006060606060000000000000000000000000000000006010101060600000000000000010101010101010600000000000000000000000000000000000006060606060606060606000000000000000000000000000000000000000000060000000000000000000000000000000000000000000000000000000600000000000000000000000000000000000000000000000000000000000000000000000000000000000000000000000000000000000000000000000000000000000000000000000101010101010101010101010101010101010101010101010101010101010101
</map>
<tip>

</tip>