<map>
0000000000000000000000000000000000000000000000000000000000000000000000000000000000000000000000000000000000000000010101010100000000000000000000000000000000000000000000000000000000000000000000000000000000000000000000000000000000000000000000000000000000000000000000000000000000000000000000000000000000000000000000000000000000000000000000000000000000000000000000000000000000000000000000000000000000000000000000010101000000000000000000010101
0000000000000000000000000000000000000000000000000000000000000000000000000000000000000000000000000000000000000000010001000100000000000000000000000000000000000000000000000000000000000000000000000000000000000000000000000000000101010101010100000000000000000000000000000000000000000000000000000000000000000000000000000000000000000000000000000000000000000000000000000000000000000000000000000000000000000000000000010001000000000000000000010001
0000000000000000000000000000000000000400000000000000000000000000000000000000000000000000000000000000000000000001010101010101000000000000000000000000000000010101000000000000000000000000000000000000000000000000000000000000000101010101010100000000000000000000000000000000000000000000000000000000000000000000000000000000000000000000000000000000000000000000000000000000000000000000000000000000000000000000000000010101000000000000000000011301
0000000000000000000000000000000101010101010100000000000000000000000000000000000000000000000000000000000000000001000100010001000000000000000000000000000000010001000000000000000000000000000000000000000000000000000000000000000100010001000100000000000000000000000000000000000000000000000000000000000000000000000000000000000000000000000000000000000000000000000000000000000000000000000000000000000000010101000000010001000000000000000000010001
0000000000000000000000000000000100010001000100000000000000000000000000000000000000000000000000000000000000000001000100010001000000000000000000000000000000010101000000000000000000000000000000000000000000000000000000000000010101010101010101000000000000000000000000000000000000000000000000000000000000000000000000000000000000000000000000000000000000000000000000000000000000000000000000000000000000010001000000010101000000000000000000010801
0000000000010101010100000000000101010101010100000000000000000000000000000000000000000000000000000000000000000001010101010101000000000000000000010101000000010909000000000000040000000000000000000000000000000000000000000000010100010001000101000000000000000000000000000000000000000000000000000000000000000000000000000000000000000000000000000000000000000000000000000000000000000000000000000000000000010101000000010001000000000000000000010001
0000000000010001000100000000000100010001000100000000000000000000000000000000000000000000000000000000000000000000080008000800000000000000000000010001000000010909000000000000010101010100000000000000000000000000000000000000010101010101010101000000000000000000000000000000000000000000000000000000000000000000000000000000000000000000000000000000000000000000000000000000000000000000000000010101010101010101010101010101010100000000000000010801
0000000000010101010100000000000101010100090000000000000000000000000000000000010101000000000000010101000000000000080008000800000000040000000000010101000000010009000000000000010001000100000000000000000000000000000000000001010100010001000101010000000000010101000000000001010100000000000000000000000001000000000000000000010000000000000000000100000000000000000000000000000000000000000000000000000000000000000000000000000100000000000000010001
0000000000010001090000000000000100010909000000000000000004000000000000000000010001000000000000010001000000000000080008000800000000010101000000010001000000010101000000000000010001000104040404040400000000000000000000000001010101010101010101010000000000010101000000000001010100000000000000000000000101010000000000000001010100000000000000010101000000000000000000000000000000000000000000000000000000000000000000000000000100000000000000000001
0000000000010109000000000000000909010109090000000000000001010101010000000000010101000000000000010101000000000001010101010101000000010001000000010101000000090001000000000000010001000101010101010101010101000000000000000001010100010001000101010000000000000101000000000001010000000000000000000000010101010100000000000101010101000000000001010101010000000000000000000000000000000000000000000000000000000000000000000000000100000000000000000001
0000000000010909000000000000000009010001090900000000000001000100010000000000010001000000000000010001000000000001000100010901000000010909000000090001000000090101000000000000010901000100010001000100010001000000000000000101010101010101010101010100000000000101000009000001010000000000000000000000010101010100000000000101010101000000000001010101010000000000000000000000000000000000000000000000010000000000000000011111110100000000000000001001
0000000000010101090000000000000009010101010100000000000001010101010000000000090101000000000000010909000000000001000109090001000000010909000000090101000009090001000000000009090101010101090909010109010909000000000000000101010100010001000101010100000000000101000000000001010000000000000000000000010001000100000000000100010001000000000001000100010000000000000000000000000000000000000000000000010000000000000000011111110100000000000000000101
0000000000010101010100000000000909010101010109000000000001010101010000000009090101000000000000010909090000000001010109000001000000010909090009090101000009090109000000090909090001090109090909090900010909090404040404040101010101010101010101010104040404040101000000000001010404040404000000000000010101000100000000000101010001000000000001010100010000000000000308000000000000000010000000000000010404040404040404011111110100000000000004040101
0101010101010101010101010101010101010101010101010101010101010101010101010101010101010101010101010101010101010101010101010101010101010101010101010101010101010101010101010101010101010101010101010101010101010101010101010101010101010101010101010101010101010101000000000001010101010101010101010101010101010101010101010101010101010101010101010101010101010101010101010101010101010112010101010101010101010101010101011111110101010101010101010101
</map>
<tip>

</tip>