<map>
0000000000000000000000000101010101010101000000000101010101010101000000000101010101010101000000000000000000000000000000000000010101000001010101000000000001010101010101010000000001010101010101010000000000000000
0000000000000000000000000101010101010101000000000101010101010101000000000101010101010101000000000000000000000000000000000001010108010101010101000000000001010101010101010000000001010101010101010000000000000000
0000000000000000000000000101000000000101000000000101000000000101000000000101000000000101000000000000010101010100000000000000060601010101000101000000000001010000000001010000000001010000000001010000000000000000
0000000000000000000000000101000000001414000000001414000000000101000000000101000000001414000000000001010101010101000000000000010101010100000101000000000001010000000001010000000001010000000001010000000000000000
0000000000000000000000000101000000000000000000000000000000000101000000000101000000000000000000000101010000000101000000000000000000000000001414000000000001010000000001010000000001010000000001010000000000000000
0000000000000000000000000101000000000000000000000000000000000101000000001414000000000000000000000101000000000101000000000000000000000000000000000000000014140000000001010000000014140000000001010000000000000000
0000000000000000000000001414000000000101000000000101000000000101000000000000000000000101000000000101000000000101010000000000010101000000000000000000000000000000000001010000000000000000000001010000000000000000
0000000000000000000000000000000000000101000000000101000000001414000000000000000000000101000000000101000000000001010100000001080101010000000101000000000000000000000014140000000000000000000015150000000000000000
0000000000000000000000000000000000000101000000000101000000000000000000000101000000000101000000000101000000000001010101010101010606000000000101000000000001010000000000000000000001010000000000000000000000000000
0000000000000000000000000101000000000101000000000101000000000000000000000101000000000101000000000101000000000000000101010101010101000000000101000000000001010000000000000000000001010000000000000000000000000000
0000000000000000000000000101000000000101000000000101000000000101000000000101000000000101000000000101000000000000000000000000000000000000000101000000000001010000000001010000000001010000000001010000000000000000
0000000000000000000000000101000000000101000000000101000000000101000000000101000000000101000000000101000000000000000000000000000000000000000101000000000001010000000001010000000001010000000001010000000000000000
0101010101010101010101010101000000000101010101010101000000000101010101010101000000000101010101010101000000000000000000000000000000000000000101010101010101010000000001010101010101010000000001010111111111010101
0101010101010101010101010101000000000101010101010101000000000101010101010101000000000101010101010101000000000000000000000000000000000000000101010101010101010000000001010101010101010000000001010101010101010100
</map>
<tip>

</tip>