<map>
00000000000000000000000000000000000000000000000000000000000000000000000000000000000004000007010000000000000000000000000000000101010000000000000000000000000000000000000000000000000000000000000000000000000000000000000000000000000000000000000000000000000000000000000000000000000000000000000000000000000000000000000000000000000000000000000000000000000000000000000000000000000000000000000000000000000000000400000000000000
00000000000000000000000000000000000000000000000007010000000000000000000000000000000001000007010000000000000000000000000000000101010000000000000000000000000100000000000000000000000000000000000000000000000000000000000000000000000000000000000000000000000000000000000000000000000000000000000000000000000000000000000000000000000000000000000000000000000000000000000000000000000000000000000000000000040001000100011111110100
00000000000000000000000000000000000000000000000007010000000000000000000001000000000000000007010000000000000000000000000000000101010000000000000000000000000100000000000000000000000000000000000000000000000000000000000803000000000000000000000000000000000000000000000000000000000000000000000000000000000000000000000000000000000000000000000000000000000000000000000000000000000000000000000004000100010001000100011111110100
00000000000000000000000000000000000000000000000007010000000000000000000000000000000000000007010000000000000000010100000000000101010000000000000000000000000100010000000000000001000000000001000000000001000000000001010101010100000000000000000000000000000000000000000000000000000000000000000000000000000000000000000000000000000000000000000000000000000000000000000000000000000000000400010001000100010001000100011111110100
00000000000000000000000000000000000000000000000007010000000000000000000000070100000000000000000000000000000000010100000000000101010000000000000001000000000100010000000000000001000000000000000000000000000000000001010101010100000000000000000000000000040000000000000400000000000004000000000000000000140000000000000000000000000000000000000000000000000000000000000000000000040001000100010001000100010001000100011111110100
00000000000000000000000000010000000000000100000007010000000000000100000000070100000000000000000000000101000000010100000000000101010000000000000001000000000100010001000000000001000000000000000000000000000000000001010101010100000000000000000000000000010000000000000100000000000001000000000000000000000000000000000000000000000000000000000000000000000000000000000004000100010001000100010001000100010001000100011111110100
00000000000000000000000000000004040404000000000000000000000000000000000000070100000000000000000000000101000000010100000000000101010000000000000001000000000100010001000000000001000000000000000000000000000000000001010101010100000000000000000000000000010000000000000100000000000001000000000000000000000000000000000000000000000000000000000000000000000000000400010001000100010001000100010001000100010001000100011111110100
00000000000000000000000000000001010101000000000000000000000000000000000000070100000404040000000000000101000000010100000000000009000000000000000001000000000100010001000100000001000000000404040000000404040000000001010101010100000000000000000001000000010000010000000100000100000001000003000000000000000000000400000004000000040000000400000004000000040001000100010001000100010001000100010001000100010001000100011111110100
01010101010101010101010101010101010101010101010101010101010101010101010101010101010101010101010101010101010101010101010101010101010101010101010101010101010101010101010101010101010101010101010101010101010101010101010101010101010101010101010101010101010101010101010101010101010101010101010101010101010101010101010101010101010101010101010101010101010101010101010101010101010101010101010101010101010101010101010101010100
00000000000000000000000000000000000000000000000000000000000000000000000000000000000000000000000000000000000000000000000000000000000000000000000000000000000000000000000000000000000000000000000000000000000000000000000000000000000000000000000000000000000000000000000000000000000000000000000000000000000000000000000000000000000000000000000000000000000000000000000000000000000000000000000000000000000000000000000000000000
00000000000000000000000000000000000000000000000000000000000000000000000000000000000000000000000000000000000000000000000000000000000000000000000000000000000000000000000000000000000000000000000000000000000000000000000000000000000000000000000000000000000000000000000000000000000000000000000000000000000000000000000000000000000000000000000000000000000000000000000000000000000000000000000000000000000000000000000000000000
00000000000000000000000000000000000000000000000000000000000000000000000000000000000000000000000000000000000000000000000000000000000000000000000000000000000000000000000000000000000000000000000000000000000000000000000000000000000000000000000000000000000000000000000000000000000000000000000000000000000000000000000000000000000000000000000000000000000000000000000000000000000000000000000000000000000000000000000000000000
00000000000000000000000000000000000000000000000000000000000000000000000000000000000000000000000000000000000000000000000000000000000000000000000000000000000000000000000000000000000000000000000000000000000000000000000000000000000000000000000000000000000000000000000000000000000000000000000000000000000000000000000000000000000000000000000000000000000000000000000000000000000000000000000000000000000000000000000000000000
00000000000000000000000000000000000000000000000000000000000000000000000000000000000000000000000000000000000000000000000000000000000000000000000000000000000000000000000000000000000000000000000000000000000000000000000000000000000000000000000000000000000000000000000000000000000000000000000000000000000000000000000000000000000000000000000000000000000000000000000000000000000000000000000000000000000000000000000000000000
</map>
<tip>

</tip>