<map>
000000000000000000000000000000010101010101010101010101010101010101010101010101010101010101010101010101010101010101010101010101010101010101010101010101010101010101010101010101010101010101010101010101
000000000000000000000000000000010100000000010000000000000001000000000000000100000000000000010000000000000000000101000000000100000000000000010000000000000001000000000000000100000000000000000000000101
000000000000000000000000000000010100000000010000000000000001000000000000000100000000000000010000000000000000000101000000000100000000000000010000000000000001000000000000000100000000000000000000000101
000000000000000000000000000000010100000000010000000000000001000000000000000100000000000000010000000000000000000101000000000100000000000000010000000000000001000000000000000100000000000000000000000101
000000000000000000000000000000010100000000010000000000000006000000000000000100000000000000010000000000000000000101000000000100000000000000060000000000000001000000000000000100000000000000000000000101
000000000000000000000000000101121501010000000000000000000000000000000000000600000000000000010000000000000001011413010100000000000000000000000000000000000006000000000000000100000000000000000000000101
000000000000000000000000000000000000000000000000000000000000000000000000000000000000000000060000000300000000000000000000000000000000000000000000000000000000000000000000000600000000000000000000000101
010101010101010101010101010101101001010000000000010101000000000001010100000000000101010000000000010101010101011010010100000000000101010000000000010101000000000001010100000000000001011111111111110101
000000000000000000000000000000010100000000000000000100000000000000010000000000000001000000000000000100000000000101000000000000000001000000000000000100000000000000010000000000000000011111111108110101
000000000000000000000000000000010100000000000000000100000000000000010000000000000001000000000000000100000000000101000000000000000001000000000000000100000000000000010000000000000000011108111111110101
000000000000000000000000000000010100000000000000000100000000000000010000000000000001000000000000000100000000000101000000000000000001000000000000000100000000000000010000000000000000011111111111110101
000000000000000000000000000000010100000000000000000100000000000000010000000000000001000000000000000100000000000101000000000000000001000000000000000100000000000000010000000000000000011111111111110101
000000000000000000000000000000010100000404040404000100040404040400010004040404040001000404040404000100000000000101000004040404040001000404040404000100040404040400010004040404040400011111110811110101
000000000000000000000000000000010101010101010101010101010101010101010101010101010101010101010101010100000000000101010101010101010101010101010101010101010101010101010101010101010101010101010101010101
</map>
<tip>

</tip>